R 800 800
NO textures/bush.xpm
SO textures/bush.xpm
WE textures/bush.xpm
EA textures/bush.xpm

SP textures/pipe.xpm
SC textures/Coin.xpm
SGM textures/mush1.xpm
SRM textures/mush2.xpm
SS textures/star2.xpm
SK textures/key.xpm
SQ textures/question.xpm
SE textures/exclamation_bock.xpm
F textures/floor1.xpm
C textures/clouds.xpm

        1211111111111111111111111
        1700002000011003000000001
        1011050000111003000200001
        1001000000000000500020001
111111111011000200111000000000601
154030000011000400011011111111111
111141111111111311011111111111111
111181111111111811811111111111111
110000000000000500000003111111111
1000000200000000000000001        
1000000000002000002000001        
100000000000000500000N031        
1000111100011100000001111        
16011  11001 1000a0001           
11111  11111 111111111           
